# # # # # # # # # # # # # # # # # # # # # # # # #
# . . E # # # # . . # . . . . . # . . . . . # # #
# . # # # . . . . # . . # # . . # . . # . . . # #
# . # . # # . # . # . . # . . # . # . . # . . . #
# . # . # . # # # # . . # . . . # . . # . . # . #
# . # . # . . . # . . # . . . # . . # . . # . . #
# . # . # . . # . . # . # . # . . . . . # . . # #
# . # . # . . # . . # . # . . . . # . # # . # . #
# . # . # . # X . . # . . # . . # . # # . . . # #
# . # . # . # # # # # # # # . # # . . . . . . # #
# . # . # . # # # # # # # # . # # . . # # # # # #
# . # . # . . . # . . . . . # # # . . . . . . . #
# . # . # # # # # # # # . # . # # . . # . # # . #
# . # # # # # # # . . . . # # # . # # # # . . . #
# . . . . . . . # . . # . # . . . . . . . . . # #
# # # # # # # . # . . # . # . # . . . . . . . # #
# . . . . . # . # . . # . . . # . . # # # # # # #
# . . . . . . . # . . # # # . # . . # # # # # # #
# # # # # # . . . . # # # . # . . . . . . . . . #
# # # # # # # # # . . # # # . # . . # # # # . . #
# # . # # # # # # . . # # # . # . . . . . . . . #
# # . # # # # # # # # # # # . # . . # # # # . . #
# # . # # # # # # # # # # # # # . . # # # # . . #
# . . . . . . . . . . . . . . . . . . . . . . . #
# # # # # # # # # # # # # # # # # # # # # # # # #
