# # # # # # # # # # # # # # # # # # # # # # # # #
# . . . # # # # . . # . . . . . # . . . . . # # #
# . # # # . . . . # . . # # . . # . . # . . . E #
# . # . # # . # . # . . # . . . . . . . . . . . #
# . # . # . # # $ . . . . . . . # . . # . . # . #
# . # . # . . . # . . # . . . # . . # . . # . . #
# . # . # . . # . . # . # . # . . . . . # . . . #
# . # . # . . # . . # . # . . . . # . # # . # . #
# . # . # . # . . . # . . # . . # . # # . . . . #
# . # . # . # # # # # # # # . # # . . . . . . # #
# . # . # . # # # # # # # # . # # . . # # # # # #
# . # . # . . . # . . . . . # # # . . . . . . . #
# . # . # # # # # # # # . # . # # . . # . # # . #
# . # # # # # # # . . . . # # # . . # # # . . . #
# . . . . . . . # . . # . # . . . . . . . . . # #
# # # # # # # . # . . # . # . # . . . . . . . # #
# . . . . . # . # . . # . . . # . . # # # # # # #
# . . . . . . . # . . # # # . # . . # # # # # # #
# # # # # # . . . . # # # . . . . . . . . . . . #
# . . . . . # # # . . # # # . # . . # # # # . . #
# . # # # . # # # . . # # # . # . . . . . . . . #
# . # X . . . . . . . . . . . # . . # # # # . . #
# . # # # . # # # # # # # # # # . . # # # # . . #
# . . . . . . . . . . . . . . . . . . . . . . . #
# # # # # # # # # # # # # # # # # # # # # # # # #
